3 3
1 1
5 5
#####
#> a#
#   #
#A <#
#####