5 5
7 7
10 10
##########
#S f A h #
##########
# t F  B #
##########
#J b < s #
##########
#  #T #>j#
#G a#g#H##
##########