7 1
7 7
10 10
##########
#WeLcOmE #
##########
# l A s T#
##########
#M a P S #
##########
#<  #o >w#
# w p#t C#
##########