5 5
6 6
10 10
##########
#        #
#   #    #
#        #
#        #
#    s   #
#     g  #
#        #
#        #
##########