3 3
5 5
9 9
#########
#   #   #
#   #   #
#  s    #
# ### ###
#   #g  #
#       #
#   #   #
#########